Like a Tattoo — Sade

VISION - Slowed — UdieNnx, HXVSAGE, Duduzinho

Redemption (feat. Nemzzz) — Kidwild, Nemzzz

Give Me More - Just Rawer — Aloboi

Latch — Disclosure, Sam Smith

Pink Plastic Kiss — Abhinsane, Arpit Bala, Sihie, Bhappa

BABY I'M BACK — The Kid LAROI

RATHER LIE (with The Weeknd) — Playboi Carti, The Weeknd

magic — Medasin, MAE.SUN, Sara Kawai

Heaven Sent — Tevomxntana

Time — Pink Floyd

NIGHTS LIKE THIS — The Kid LAROI

Adhura Hee Sahi — Bhappa, A.O.D., Arpit Bala

Last Son — David Fleming

No Pole — Don Toliver

I'm God — Clams Casino, Imogen Heap

Headlock — Imogen Heap

sdp interlude — Travis Scott

New Person, Same Old Mistakes — Tame Impala

Let It Happen — Tame Impala

Chamber Of Reflection — Mac DeMarco

Borderline — Tame Impala

welcome and goodbye — Dream, Ivory

Softcore — The Neighbourhood

We Are The People — Empire Of The Sun

The Less I Know The Better — Tame Impala

All I Need — Radiohead

SLOW DANCING IN THE DARK — Joji

Tek It — Cafuné

Heart To Heart — Mac DeMarco

Resonance — Home

Not Allowed — TV Girl

Something About You — Eyedress, Dent May

Where’d All the Time Go? — Dr. Dog

No Idea — Don Toliver

Notion — The Rare Occasions

Everything In Its Right Place — Radiohead

Evergreen — Richy Mitch & The Coal Miners

End of Beginning — Djo

Goth — Sidewalks and Skeletons

Sailor Song — Gigi Perez

Walking On A Dream — Empire Of The Sun

Suffocation — Crystal Castles

Exit Music (For A Film) — Radiohead

Nothing’s New — Rio Romeo

Homage — Mild High Club

Killswitch Lullaby — Flawed Mangoes

So High — Doja Cat

Swim — Chase Atlantic

LOVE. FEAT. ZACARI. — Kendrick Lamar, Zacari